{
    "TC1028": 8,
    "TC1033": 1,
    "TC1027": 4,
    "TC1001B": 1,
    "TC1031": 1,
    "TC1032": 1,
    "TC1004B": 1,
    "TI1015": 1,
    "TC2038": 1,
    "TC2007B": 1,
    "TC2008B": 1
}