{
    "1": [
        "TC1028",
        "TC1031",
        "TC2038",
        "TC2007B"
    ],
    "2": [
        "TC1027",
        "TC1028",
        "TC1031",
        "TC1032",
        "TC1004B",
        "TC2038",
        "TC2007B"
    ],
    "3": [
        "TC1031",
        "TC1033",
        "TC1001B",
        "TC1004B",
        "TC2038",
        "TC2008B",
        "TI1015"
    ]
}